*********G*******************
*       *                   *
* ************************* *
* *            *            *
* ****** ****************** *
*              *            *
* ****** ****************** *
* *                         *
* ************************* *
* *       *         *       *
* ******* ********* *********
*                           *
****** ******* ****** ***** *
*            *      *     * *
******S**********************